                                        #
                                        #   
                                #########           #######
#####


        ###     #####       #####   #####   #####
####        
                    
                #########
      ###                                           ########
      #                         ###
#######      ####                                                   
#                                            #########
#                    ####                        
#                                            
#                                            
######################################################################